%%%%%%%%%%%%%%%%%%%%%%%%%%%%%%%%%%%%%%
%...................................P%
%....................................%
%....................................%
%....................................%
%....................................%
%....................................%
%....................................%
%....................................%
%....................................%
%....................................%
%....................................%
%....................................%
%....................................%
%%%%%%%%%%%%%%%%%%%%%%%%%%%%%%%%%%%%%%